XXXXXXXXXXXXXXXXXXX
XYYYXYYYYYYXYYYYYYX
XYYYXYYYYYYXYYYYYYX
XYYYXXXYYYYXYYYYYYX
XYYYYYXYYYYYYYYYYYX
XYYYYYYYYYYYYYYYYYX
XYYYYYXXXXYYXYYYYYX
XYYYYYYYYXXXXYYYYYX
XYYYYYYYYXYYYYYYYYX
XYYYYYYYYYYYYYYYYYX
XXXXXXXXYYYYYYYYYYX
XYYYYYYYYYYXYYYYYYX
XYYYYYYYYYYYXXXXYYX
XXXXXXXXXXXXXXXXXXX
